1111111111111111111111111111
1CCCCCCCCCCCCCCCCCCCCCCCCCC1
1C11C1111C11111111C1111C11C1
1C11C1111C11111111C1111C11C1
1C11CCCCCC11CCCC11CCCCCC11C1
1C1111C11C11C11C11C11C1111C1
1C1111C11C11C11C11C11C1111C1
1CCCCCC11CCCC11CCCC11CCCCCC1
111C11111111011011111111C111
111C11111111011011111111C111
111000P11000011000011E000111
111011C11011111111011C110111
T00011C11011111111011C11000T
111111C000M0M00M0M000C111111
111111C11011111111011C111111
T00011C11000000000011C11000T
111011C11111011011111C110111
111CCCC11111011011111CCCC111
111C11C11111011011111C11C111
111C11CCCCCCC11CCCCCCC11C111
111C11111C11C11C11C11111C111
111C11111C11C11C11C11111C111
1CCCCCCCCC11CCCC11CCCCCCCCC1
1C1111C11C11111111C11C1111C1
1C1111C11C11111111C11C1111C1
1C11CCC11CCCCCCCCCC11CCC11C1
1C11C1111111C11C1111111C11C1
1C11C1111111C11C1111111C11C1
1CCCCCCCCCCCC11CCCCCCCCCCCC1
1111111111111111111111111111
