1111111111111TT1111111111111
1CCCCCCCCCCCC00CCCCCCCCCCCC1
1C1111C11111C11C11111C1111C1
1B1111C11111C11C11111C1111B1
1C1111C11111C11C11111C1111C1
1CCCCCCCCCCCCCCCCCCCCCCCCCC1
1C1111C11011111111011C1111C1
1C1111C11011111111011C1111C1
1CCCCCC11000011000011CCCCCC1
111111C11111011011111C111111
111111C11111011011111C111111
111111C11000000000011C111111
111111C11011111111011C111111
T00000C000M0M00M0M000C00000T
111111C11011111111011C111111
111111C11000000000011C111111
111111C11011111111011C111111
111111C11011111111011C111111
1CCCCCC00000P11E00000CCCCCC1
1C1111C11111011011111C1111C1
1C1111C11111011011111C1111C1
1BCC11CCCCCCCCCCCCCCCC11CCB1
111C11C11C11111111C11C11C111
111C11C11C11111111C11C11C111
1CCCCCC11CCCC11CCCC11CCCCCC1
1C1111111111C11C1111111111C1
1C1111111111C11C1111111111C1
1CCCCCCCCCCCCCCCCCCCCCCCCCC1
1111111111111TT1111111111111
