1111111111111111111111111111
1011111CCCC111111CCCC1111101
1011111C11C111111C11C1111101
1011111C11CCC11CCC11C1111101
1011111C1111C11C1111C1111101
1011111C1111C11C1111C1111101
T000000B11CCCCCCCC11B000000T
111C111111C111111C111111C111
111C111111C111111C111111C111
1CCCCCCC11CCC11CCC11CCCCCCC1
1C11111C1111C11C1111C11111C1
1C11111C1111C11C1111C11111C1
1CCCC11C1111C11C1111C11CCCC1
1111C11C100000000001C11C1111
1111C11C101111111101C11C1111
T011C00000M0M00M0M00000C110T
1011C111101111111101111C1101
1000C111101111111101111C0001
1011C111101111111101111C1101
1011C111101111111101111C1101
T011C1111000P11E0001111C110T
1111C111111101101111111C1111
1111C111111101101111111C1111
1CCCBCCCCCCCCCCCCCCCCCCBCCC1
1C11C111111111111111111C11C1
1C11C111111111111111111C11C1
1C11C111111111111111111C11C1
1C11C111111111111111111C11C1
1CCCC111111111111111111CCCC1
1111111111111111111111111111
